NO ./wall1.xpm
SO ./wall2.xpm
WE ./wall3.xpm
EA ./wall4.xpm

F 139,69,19
C 0,0,255

        1111111111111111111111111
        1000000000110000000000001
        1011000001110000000000001
        1001000000000000000000001
111111111011000001110000000000001
100000000011000001110111110111111
11110111111111011100000010001
11110111111111011101010010001
11000000110101011100000010001
10000000000000000000000000001
10000000000000001101010010001
11000001110101011111011110W0111
11110111 1110101 101111010001
11111111 1111111 111111111111